##########################################################################
#   #                           #    #                               #   #
#   #  #### ## ## ### ## ### ## ## ### # ## #### ## ## ### ## ### ## #   #
#      #              #    # #     # #    # #              #    # #      #
###    # # # ### ### ## ## #       #     ## # # # ### ### ## ## #      ###
#   #  # #     #        #  # #    ####      # #     #        #  # ##     #
# ##     ### # #####  # ## # # ## #   # ## # #         ######## # #  #   #
# #      #   #  #          # #  #   ## ##     ### # #####  # ## # # ## # #
# ### # ## #### # ###    ### #    #           #   #              #       #
#     #    # #  #          #   ## # ### ## # #         ###  ### # #  #   #
## ## # #         ######## # #  #          #    # #  #          #   ## # #
#   # # # #### #         # # ## ## # # # # ## ### #   #   # ##### ## #####
# # # #      # ### ### #   #  #     ##      #   # #            #         #
# # # ## ### #   #   # ##### ## ####### ## # #      #  ######## # #  #   #
#     #      # #   #         #             #   # #            #      #   #
# ### #   ## ###  #######  #### ######        #     #            #       |
#          # #                      #  ## # #         ######## # #  #    #
###    # ### # ####  #### ### ### ####      #   # #            #       ###
#      #   # #            #          ###    # # # # ####  #### ###       #
#   # ## # # ###   #   #### ####### ## # # ## ### #   #   #  ###     #   #
#   #    #                  #        #        #                   #  #   #
##########################################################################
